****************************
*                          *
*                          *
**********  ****************
*   *                      *
*   ***  *******************
*                          *
*   0                      *
****************************
